XXXXXXXXXXXXXXXXXX
X_____X___X______X
X_______AAX______X
X_____X_AAX______X
X_____XXXXX______X
X_____X___X______X
X_____X___X______X