____XXXXXXXXX
____X__P___VXXXXX
____X___________X
____X____H___A__X
____X_3SS__2____X
____X__SS____3__X
____X___________X
XXXXXXXXXXXXX___X
X______________XX
X______G_______X
X______________X
X_______G______X
XXXXXXXXXXXXXXXX
%